111111111111111111
100000000CPE111111
111111111111111111
