111111111111111111111111
1E00000000000000000001C1
1PCCCCCCCCCCCCCCCCCC0011
111111111111111111111111
