111111111111111111111111
1E0000000000000000011C11
1PCCCCCCCCCCCCCCCCCC0111
111111111111111111111111
