1111111111
1EPC111111
1111111111
1111111111
1111111111
1111111111
1111111111
1111111111
1111111111
1111111111
