111111111111111
111110000000EC1
111111000000011
1P0000000000001
111111111111111
