1111111111
1ECPCCCC11
1000000001
1111111111
