11111111111111111111111
10000000000000000000001
1PE11111111111111111111
10000CC0000000000000001
11111111111111111111111
